11111111111111111111
11111111111111111111
1C0000001111C00001E1
11100100000000110101
1C10011111110001C101
101111100EC110011101
100P00000000000000P1
11111111111111111111
